[
	[" ", " ", " ", " ", " ", " ", " ", " ", " ", " ", " ", " ", " ", " "],
	[" ", " ", " ", " ", " ", " ", " ", " ", " ", " ", " ", "B", " ", " "],
	[" ", " ", " ", " ", " ", " ", " ", " ", " ", " ", " ", " ", " ", " "],
	[" ", " ", " ", " ", " ", " ", " ", "A", " ", " ", " ", " ", " ", " "],
	[" ", " ", " ", " ", " ", " ", " ", " ", " ", " ", " ", " ", " ", " "],
	[" ", " ", " ", " ", " ", " ", " ", " ", " ", " ", " ", " ", " ", " "],
	[" ", " ", " ", " ", "B", " ", " ", " ", " ", " ", " ", " ", " ", " "],
	[" ", " ", " ", " ", " ", " ", " ", " ", " ", " ", "C", " ", " ", " "],
	[" ", " ", " ", " ", " ", " ", " ", " ", " ", " ", " ", " ", " ", " "],
	[" ", " ", " ", "A", " ", " ", " ", " ", " ", " ", " ", " ", " ", " "],
	[" ", "A", " ", " ", " ", " ", " ", " ", " ", " ", " ", " ", " ", " "],
	[" ", " ", " ", " ", " ", " ", " ", " ", " ", " ", " ", " ", " ", " "],
	[" ", " ", " ", " ", " ", " ", " ", " ", " ", " ", " ", " ", " ", " "],
	[" ", " ", " ", " ", " ", " ", " ", " ", " ", " ", " ", " ", " ", " "]
]
