[
	[" ", " ", " ", " ", " ", " ", " ", " ", " ", " ", " ", " ", " ", " "],
	[" ", " ", " ", " ", " ", " ", " ", " ", " ", " ", " ", "B", " ", " "],
	[" ", " ", " ", " ", " ", " ", " ", " ", " ", " ", " ", " ", " ", " "],
	[" ", " ", " ", " ", " ", " ", " ", "B", " ", " ", " ", " ", " ", " "],
	[" ", " ", " ", " ", " ", " ", " ", " ", " ", " ", " ", " ", " ", " "],
	[" ", " ", " ", "O", " ", " ", " ", " ", " ", " ", " ", " ", " ", " "],
	[" ", " ", " ", " ", "R", " ", " ", " ", " ", " ", " ", " ", " ", " "],
	[" ", " ", " ", " ", " ", " ", " ", " ", " ", " ", "W", " ", " ", " "],
	[" ", " ", " ", " ", " ", " ", " ", " ", " ", " ", " ", " ", " ", " "],
	[" ", " ", " ", "S", " ", " ", " ", " ", " ", " ", " ", " ", " ", " "],
	[" ", "S", " ", " ", " ", " ", " ", " ", " ", " ", " ", " ", " ", " "],
	[" ", " ", " ", " ", " ", " ", " ", " ", " ", " ", " ", " ", " ", " "],
	[" ", " ", " ", "W", "W", "8", "8", "8", "W", " ", " ", " ", " ", " "],
	[" ", " ", " ", " ", " ", " ", " ", " ", " ", " ", " ", " ", " ", " "]
]
